elephant - слон
lion - лъв
penguin - пингвин
bear - мечка
giraffe - жираф
hippo - хипопотам
monkey - маймуна
turtle - костенурка
zebra - зебра
apple - ябълка
banana - банан
orange - портокал
strawberry - ягода
tomato - домат
potato - картоф
pepper - чушка
kiwi - киви
broccoli - броколи
girl - момиче
boy - момче
baby - бебе
woman - жена
man - мъж
dog - куче
cat - коте
parrot - папагал
rabbit - заек
white - бял
yellow - жълт
orange - оранжев
red - червен
pink - розов
purple - лилав
blue - син
green - зелен
black - черен
chair - стол
table - маса
sofa - диван
armchair - кресло
lamp - лампа
shelf - лавица
wardrobe - гардероб
desk - бюро
door - врата
sandwich - сандвич
salad - салата
chicken - пиле
cake - торта
ice cream - сладолед
chocolate - шоколад
water - вода
juice - сок
milk - мляко
hand - ръка
arm - ръка
leg - крак
foot - ходило
head - глава
eye - око
nose - нос
mouth - уста
hair - коса
tall - висок
short - нисък
weak - слаб
strong - силен
surprised - изненадан
angry - ядосан
scared - изплашен
excited - развълнуван
happy - щастлив
sun - слънце
cloud - облак
park - парк
grass - трева
tree - дърво
bench - пейка
skateboard - скейтборд
ball - топка
kite - хвърчило
house - къща
roof - покрив
wall - стена
window - прозорец
chimney - комин
room - стая
stairs - стълбище
doorbell - звънец
garden - градина
sea - море
beach - плаж
umbrella - чадър
sand - пясък
spade - лопатка
bucket - кофичка
sandcastle - пясъчен замък
boat - лодка
shell - мида
bathroom - баня
toilet - тоалетна
shower - душ
bath - вана
sink - мивка
towel - хавлия
soap - сапун
toothbrush - четка за зъби
mirror - огледало
spoon - лъжица
fork - вилица
bottle - бутилка
plate - чиния
cup - чаша
hot - гореща
cold - студена
big - голяма
small - малка